XXXXXXXXXXXXXXXXXXXXXXXXXXX
X............X............X
X.XXXX.XXXXX.X.XXXXX.XXXX.X
XoXXXX.XXXXX.X.XXXXX.XXXXoX
X.XXXX.XXXXX.X.XXXXX.XXXX.X
X.........................X
X.XXXX.XX.XXXXXXX.XX.XXXX.X
X.XXXX.XX.XXXXXXX.XX.XXXX.X
X......XX....X....XX......X
XXXXXX.XXXXX_X_XXXXX.XXXXXX
XXXXXX.X_____B_____X.XXXXXX
XXXXXX.X_XXXX_XXXX_X.XXXXXX
XXXXXX.X_X_______X_X.XXXXXX
X_____.__X_I___P_X__._____X
XXXXXX.X_X___C___X_X.XXXXXX
XXXXXX.X_XXXXXXXXX_X.XXXXXX
XXXXXX._____________.XXXXXX
XXXXXX.X_XXXXXXXXX_X.XXXXXX
X............X............X
X.XXXX.XXXXX.X.XXXXX.XXXX.X
Xo..XX.XXXXX.X.XXXXX.XX..oX
XXX.XX.......M.......XX.XXX
XXX.XX.X.XXXXXXXXX.X.XX.XXX
X......X.....X.....X......X
X.XXXXXXXXXX.X.XXXXXXXXXX.X
X.........................X
XXXXXXXXXXXXXXXXXXXXXXXXXXX

